"a" = (/turf,/area/dark)
"b" = (/turf/platform,/area/dark)
"c" = (/turf/start,/area/dark)
"d" = (/obj/torch,/turf,/area/dark)
"e" = (/obj/torch,/turf/platform,/area/dark)

(1,1,1) = {"
daaaaaaaad
aaaaaaaaaa
aaaaaaaaaa
aaaaaaaaaa
aaaaaaaaaa
caaaaaaaaa
aaaaaaaaaa
bbbaaaaaaa
bbbaaaaaaa
ebbaaaaaad
"}
